##########
#  #     E
# ## #####
# #      #
# #####  #
#^       #
##########
